NO ./texture/test.xpm
SO ./texture/egg.xpm
WE ./texture/sand_wall.xpm
EA ./texture/sand.xpm

C 229,255,255
F 204,255,204

111111111111111111111111111111111111111111111111111111111111111111111111
100000000000000000000000000000000000000000000000000000000000000000000001
100000000000000000000000000000000000000000000000000000000000000000000001
100000000000000000000000000000000000000000000000000000000000000000000001
100000000000000000000000000000000000000000000000000000000000000000000001
100000000000000000000000000000000000000000000000000000000000000000000001
100000000000000000000000000000000000000000000000000000000000000000000001
100000000000000000000000000000000000000000000000000000000000000000000001
100000000000000000000000000000000000000000000000000000000000000000000001
100000000000000000000000000000000000000000000000000000000000000000000001
100000000000000000000000000000000000000000000000000000000000000000000001
100000000000000000000000000000000000000000000000000000000000000000000001
100000000000000000000000000000000000000000000000000000000000000000000001
100000000000000000000000000000000000000000000000000000000000000000000001
100000000000000000000000000000000000000000000000000000000000000000000001
100000000000000000000000000000000000000000000000000000000000000000000001
100000000000000000000000000000000000000000000000000000000000000000000001
1000000000000000000000000000000N0000000000000000000000000000000000000001
100000000000000000000000000000000000000000000000000000000000000000000001
100000000000000000000000000000000000000000000000000000000000000000000001
100000000000000000000000000000000000000000000000000000000000000000000001
100000000000000000000000000000000000000000000000000000000000000000000001
100000000000000000000000000000000000000000000000000000000000000000000001
100000000000000000000000000000000000000000000000000000000000000000000001
100000000000000000000000000000000000000000000000000000000000000000000001
100000000000000000000000000000000000000000000000000000000000000000000001
100000000000000000000000000000000000000000000000000000000000000000000001
100000000000000000000000000000000000000000000000000000000000000000000001
100000000000000000000000000000000000000000000000000000000000000000000001
100000000000000000000000000000000000000000000000000000000000000000000001
100000000000000000000000000000000000000000000000000000000000000000000001
100000000000000000000000000000000000000000000000000000000000000000000001
100000000000000000000000000000000000000000000000000000000000000000000001
100000000000000000000000000000000000000000000000000000000000000000000001
10000000000000000000000000000000000000000000000000000000000000000000000111111111111111111111111111111111111
10000000000000000000000000000000000000000000000000000000000000000000000000000000000000000000000000000000001
10000000000000000000000000000000000000000000000000000000000000000000000000000000000000000000000000000000001
10000000000000000000000000000000000000000000000000000000000000000000000000000000000000000000000000000000001
10000000000000000000000000000000000000000000000000000000000000000000000000000000000000000000000000000000001
10000000000000000000000000000000000000000000000000000000000000000000000000000000000000000000000000000000001
10000000000000000000000000000000000000000000000000000000000000000000000000000000000000000000000000000000001
10000000000000000000000000000000000000000000000000000000000000000000000000000000000000000000000000000000001
10000000000000000000000000000000000000000000000000000000000000000000000000000000000000000000000000000000001
10000000000000000000000000000000000000000000000000000000000000000000000000000000000000000000000000000000001
10000000000000000000000000000000000000000000000000000000000000000000000000000000000000000000000000000000001
10000000000000000000000000000000000000000000000000000000000000000000000000000000000000000000000000000000001
10000000000000000000000000000000000000000000000000000000000000000000000000000000000000000000000000000000001
10000000000000000000000000000000000000000000000000000000000000000000000000000000000000000000000000000000001
10000000000000000000000000000000000000000000000000000000000000000000000000000000000000000000000000000000001
10000000000000000000000000000000000000000000000000000000000000000000000000000000000000000000000000000000001
10000000000000000000000000000000000000000000000000000000000000000000000000000000000000000000000000000000001
10000000000000000000000000000000000000000000000000000000000000000000000000000000000000000000000000000000001
10000000000000000000000000000000000000000000000000000000000000000000000000000000000000000000000000000000001
10000000000000000000000000000000000000000000000000000000000000000000000000000000000000000000000000000000001
10000000000000000000000000000000000000000000000000000000000000000000000000000000000000000000000000000000001
10000000000000000000000000000000000000000000000000000000000000000000000000000000000000000000000000000000001
10000000000000000000000000000000000000000000000000000000000000000000000000000000000000000000000000000000001
10000000000000000000000000000000000000000000000000000000000000000000000000000000000000000000000000000000001
10000000000000000000000000000000000000000000000000000000000000000000000000000000000000000000000000000000001
10000000000000000000000000000000000000000000000000000000000000000000000000000000000000000000000000000000001
10000000000000000000000000000000000000000000000000000000000000000000000000000000000000000000000000000000001
10000000000000000000000000000000000000000000000000000000000000000000000000000000000000000000000000000000001
10000000000000000000000000000000000000000000000000000000000000000000000000000000000000000000000000000000001
10000000000000000000000000000000000000000000000000000000000000000000000000000000000000000000000000000000001
10000000000000000000000000000000000000000000000000000000000000000000000000000000000000000000000000000000001
10000000000000000000000000000000000000000000000000000000000000000000000000000000000000000000000000000000001
10000000000000000000000000000000000000000000000000000000000000000000000000000000000000000000000000000000001
10000000000000000000000000000000000000000000000000000000000000000000000000000000000000000000000000000000001
10000000000000000000000000000000000000000000000000000000000000000000000000000000000000000000000000000000001
10000000000000000000000000000000000000000000000000000000000000000000000000000000000000000000000000000000001
10000000000000000000000000000000000000000000000000000000000000000000000000000000000000000000000000000000001
10000000000000000000000000000000000000000000000000000000000000000000000000000000000000000000000000000000001
10000000000000000000000000000000000000000000000000000000000000000000000000000000000000000000000000000000001
10000000000000000000000000000000000000000000000000000000000110000000000000000000000000000000000000000000001
10000000000000000000001100000000000000000000000000000000000110000000000000000000000000000000000000000000001
10000000000000000000001100000000000000000000000000000000000110000000000000000000000000000000000000000000001
10000000000000000000001100000000000000000000000000000000000110000000000000000000000000000000000000000000001
10000000000000000000001100000000000000000000000000000000000001100000000000000000000000000000000000000000001
10000000000000000000001100000000000000000000000000000000000001100000000000000000000000000000000000000000001
10000000000000000000001100000000000000000000000000000000000001100000000000000000000000000000000000000000001
10000000000000000000001100000000000000000000000000000000000001100000000000000000000000000000000000000000001
10000000000000000000001100000000000000000000000000000000000001100000000000000000000000000000000000000000001
10000000000000000000001100000000000000000000000000000000000001100000000000000000000000000000000000000000001
10000000000000000000001100000000000000000000000000000000000001100000000000000000000000000000000000000000001
10000000000000000000001100000000000000000000000000000000000001100000000000000000000000000000000000000000001
10000000000000000000001100000000000000000000000000000000000001100000000000000000000000000000000000000000001
10000000000000000000001100000000000000000000000000000000000001100000000000000000000000000000000000000000001
10000000000000000000001100000000000000000000000000000000000001100000000000000000000000000000000000000000001
10000000000000000000001100000000000000000000000000000000000001100000000000000000000000000000000000000000001
10000000000000000000001100000000000000000000000000000000000001100000000000000000000000000000000000000000001
10000000000000000000001100000000000000000000000000000000000001100000000000000000000000000000000000000000001
10000000000000000000001100000000000000000000000000000000000001100000000000000000000000000000000000000000001
10000000000000000000001100000000000000000000000000000000000001100000000000000000000000000000000000000000001
10000000000000000000001100000000000000000000000000000000000001100000000000000000000000000000000000000000001
10000000000000000000001100000000000000000000000000000000000001100000000000000000000000000000000000000000001
10000000000000000000001100000000000000000000000000000000000001100000000000000000000000000000000000000000001
10000000000000000000001100000000000000000000000000000000000001100000000000000000000000000000000000000000001
10000000000000000000001100000000000000000000000000000000000001100000000000000000000000000000000000000000001
10000000000000000000001100000000000000000000000000000000000001100000000000000000000000000000000000000000001
10000000000000000000001100000000000000000000000000000000000001100000000000000000000000000000000000000000001
10000000000000000000001100000000000000000000000000000000000001100000000000000000000000000000000000000000001
10000000000000000000001100000000000000000000000000000000000001100000000000000000000000000000000000000000001
10000000000000000000001100000000000000000000000000000000000001100000000000000000000000000000000000000000001
10000000000000000000001100000000000000000000000000000000000001100000000000000000000000000000000000000000001
10000000000000000000001100000000000000000000000000000000000001100000000000000000000000000000000000000000001
10000000000000000000001100000000000000000000000000000000000001100000000000000000000000000000000000000000001
10000000000000000000001100000000000000000000000000000000000001100000000000000000000000000000000000000000001
10000000000000000000001100000000000000000000000000000000000001100000000000000000000000000000000000000000001
10000000000000000000001100000000000000000000000000000000000001100000000000000000000000000000000000000000001
10000000000000000000001100000000000000000000000000000000000001100000000000000000000000000000000000000000001
10000000000000000000001100000000000000000000000000000000000001100000000000000000000000000000000000000000001
10000000000000000000001100000000000000000000000000000000000001100000000000000000000000000000000000000000001
10000000000000000000001100000000000000000000000000000000000001100000000000000000000000000000000000000000001
10000000000000000000001100000000000000000000000000000000000001100000000000000000000000000000000000000000001
10000000000000000000001100000000000000000000000000000000000001100000000000000000000000000000000000000000001
10000000000000000000001100000000000000000000000000000000000001100000000000000000000000000000000000000000001
10000000000000000000001100000000000000000000000000000000000001100000000000000000000000000000000000000000001
10000000000000000000001100000000000000000000000000000000000001100000000000000000000000000000000000000000001
10000000000000000000001100000000000000000000000000000000000001100000000000000000000000000000000000000000001
10000000000000000000001100000000000000000000000000000000000001100000000000000000000000000000000000000000001
10000000000000000000001100000000000000000000000000000000000001100000000000000000000000000000000000000000001
10000000000000000000001100000000000000000000000000000000000001100000000000000000000000000000000000000000001
10000000000000000000001100000000000000000000000000000000000001100000000000000000000000000000000000000000001
10000000000000000000001100000000000000000000000000000000000001100000000000000000000000000000000000000000001
10000000000000000000001100000000000000000000000000000000000001100000000000000000000000000000000000000000001
10000000000000000000001100000000000000000000000000000000000001100000000000000000000000000000000000000000001
10000000000000000000001100000000000000000000000000000000000001100000000000000000000000000000000000000000001
10000000000000000000001100000000000000000000000000000000000001100000000000000000000000000000000000000000001
10000000000000000000001100000000000000000000000000000000000001100000000000000000000000000000000000000000001
10000000000000000000001100000000000000000000000000000000000001100000000000000000000000000000000000000000001
10000000000000000000001100000000000000000000000000000000000001100000000000000000000000000000000000000000001
10000000000000000000001100000000000000000000000000000000000001100000000000000000000000000000000000000000001
10000000000000000000001100000000000000000000000000000000000001100000000000000000000000000000000000000000001
10000000000000000000001100000000000000000000000000000000000001100000000000000000000000000000000000000000001
10000000000000000000001100000000000000000000000000000000000001100000000000000000000000000000000000000000001
10000000000000000000001100000000000000000000000000000000000001100000000000000000000000000000000000000000001
10000000000000000000001100000000000000000000000000000000000001100000000000000000000000000000000000000000001
10000000000000000000001100000000000000000000000000000000000001100000000000000000000000000000000000000000001
10000000000000000000001100000000000000000000000000000000000001100000000000000000000000000000000000000000001
10000000000000000000001100000000000000000000000000000000000001100000000000000000000000000000000000000000001
10000000000000000000001100000000000000000000000000000000000001100000000000000000000000000000000000000000001
10000000000000000000001100000000000000000000000000000000000001100000000000000000000000000000000000000000001
10000000000000000000001100000000000000000000000000000000000001100000000000000000000000000000000000000000001
10000000000000000000001100000000000000000000000000000000000001100000000000000000000000000000000000000000001
10000000000000000000001100000000000000000000000000000000000001100000000000000000000000000000000000000000001
10000000000000000000001100000000000000000000000000000000000001100000000000000000000000000000000000000000001
10000000000000000000001100000000000000000000000000000000000001100000000000000000000000000000000000000000001
10000000000000000000001100000000000000000000000000000000000001100000000000000000000000000000000000000000001
10000000000000000000001100000000000000000000000000000000000001100000000000000000000000000000000000000000001
10000000000000000000001100000000000000000000000000000000000001100000000000000000000000000000000000000000001
10000000000000000000001100000000000000000000000000000000000001100000000000000000000000000000000000000000001
10000000000000000000001100000000000000000000000000000000000001100000000000000000000000000000000000000000001
10000000000000000000001100000000000000000000000000000000000001100000000000000000000000000000000000000000001
10000000000000000000001100000000000000000000000000000000000001100000000000000000000000000000000000000000001
10000000000000000000001100000000000000000000000000000000000001100000000000000000000000000000000000000000001
10000000000000000000001100000000000000000000000000000000000001100000000000000000000000000000000000000000001
10000000000000000000001100000000000000000000000000000000000001100000000000000000000000000000000000000000001
10000000000000000000001100000000000000000000000000000000000001100000000000000000000000000000000000000000001
10000000000000000000001100000000000000000000000000000000000001100000000000000000000000000000000000000000001
10000000000000000000001100000000000000000000000000000000000001100000000000000000000000000000000000000000001
10000000000000000000001100000000000000000000000000000000000001100000000000000000000000000000000000000000001
10000000000000000000001100000000000000000000000000000000000001100000000000000000000000000000000000000000001
10000000000000000000001100000000000000000000000000000000000001100000000000000000000000000000000000000000001
10000000000000000000001100000000000000000000000000000000000001100000000000000000000000000000000000000000001
10000000000000000000001100000000000000000000000000000000000001100000000000000000000000000000000000000000001
10000000000000000000001100000000000000000000000000000000000001100000000000000000000000000000000000000000001
10000000000000000000001100000000000000000000000000000000000001100000000000000000000000000000000000000000001
10000000000000000000001100000000000000000000000000000000000001100000000000000000000000000000000000000000001
10000000000000000000001100000000000000000000000000000000000001100000000000000000000000000000000000000000001
10000000000000000000001100000000000000000000000000000000000001100000000000000000000000000000000000000000001
10000000000000000000001100000000000000000000000000000000000001100000000000000000000000000000000000000000001
10000000000000000000001100000000000000000000000000000000000001100000000000000000000000000000000000000000001
10000000000000000000001100000000000000000000000000000000000001100000000000000000000000000000000000000000001
10000000000000000000001100000000000000000000000000000000000001100000000000000000000000000000000000000000001
10000000000000000000001100000000000000000000000000000000000001100000000000000000000000000000000000000000001
10000000000000000000001100000000000000000000000000000000000001100000000000000000000000000000000000000000001
10000000000000000000001100000000000000000000000000000000000001100000000000000000000000000000000000000000001
10000000000000000000001100000000000000000000000000000000000001100000000000000000000000000000000000000000001
10000000000000000000001100000000000000000000000000000000000001100000000000000000000000000000000000000000001
10000000000000000000001100000000000000000000000000000000000001100000000000000000000000000000000000000000001
10000000000000000000001100000000000000000000000000000000000001100000000000000000000000000000000000000000001
10000000000000000000001100000000000000000000000000000000000001100000000000000000000000000000000000000000001
10000000000000000000001100000000000000000000000000000000000001100000000000000000000000000000000000000000001
10000000000000000000001100000000000000000000000000000000000001100000000000000000000000000000000000000000001
10000000000000000000001100000000000000000000000000000000000001100000000000000000000000000000000000000000001
10000000000000000000001100000000000000000000000000000000000001100000000000000000000000000000000000000000001
10000000000000000000001100000000000000000000000000000000000001100000000000000000000000000000000000000000001
10000000000000000000001100000000000000000000000000000000000001100000000000000000000000000000000000000000001
10000000000000000000001100000000000000000000000000000000000001100000000000000000000000000000000000000000001
10000000000000000000001100000000000000000000000000000000000001100000000000000000000000000000000000000000001
10000000000000000000001100000000000000000000000000000000000001100000000000000000000000000000000000000000001
10000000000000000000001100000000000000000000000000000000000001100000000000000000000000000000000000000000001
10000000000000000000001100000000000000000000000000000000000001100000000000000000000000000000000000000000001
10000000000000000000001100000000000000000000000000000000000001100000000000000000000000000000000000000000001
10000000000000000000001100000000000000000000000000000000000001100000000000000000000000000000000000000000001
10000000000000000000001100000000000000000000000000000000000001100000000000000000000000000000000000000000001
10000000000000000000001100000000000000000000000000000000000001100000000000000000000000000000000000000000001
10000000000000000000001100000000000000000000000000000000000001100000000000000000000000000000000000000000001
10000000000000000000001100000000000000000000000000000000000001100000000000000000000000000000000000000000001
10000000000000000000001100000000000000000000000000000000000001100000000000000000000000000000000000000000001
10000000000000000000001100000000000000000000000000000000000001100000000000000000000000000000000000000000001
10000000000000000000001100000000000000000000000000000000000001100000000000000000000000000000000000000000001
10000000000000000000001100000000000000000000000000000000000001100000000000000000000000000000000000000000001
10000000000000000000001100000000000000000000000000000000000001100000000000000000000000000000000000000000001
10000000000000000000001100000000000000000000000000000000000001100000000000000000000000000000000000000000001
10000000000000000000001100000000000000000000000000000000000001100000000000000000000000000000000000000000001
10000000000000000000001100000000000000000000000000000000000001100000000000000000000000000000000000000000001
10000000000000000000001100000000000000000000000000000000000001100000000000000000000000000000000000000000001
10000000000000000000001100000000000000000000000000000000000001100000000000000000000000000000000000000000001
10000000000000000000001100000000000000000000000000000000000001100000000000000000000000000000000000000000001
10000000000000000000001100000000000000000000000000000000000001100000000000000000000000000000000000000000001
10000000000000000000001100000000000000000000000000000000000001100000000000000000000000000000000000000000001
10000000000000000000001100000000000000000000000000000000000001100000000000000000000000000000000000000000001
10000000000000000000001100000000000000000000000000000000000001100000000000000000000000000000000000000000001
10000000000000000000001100000000000000000000000000000000000001100000000000000000000000000000000000000000001
10000000000000000000001100000000000000000000000000000000000001100000000000000000000000000000000000000000001
10000000000000000000001100000000000000000000000000000000000001100000000000000000000000000000000000000000001
10000000000000000000001100000000000000000000000000000000000001100000000000000000000000000000000000000000001
10000000000000000000001100000000000000000000000000000000000001100000000000000000000000000000000000000000001
10000000000000000000001100000000000000000000000000000000000001100000000000000000000000000000000000000000001
10000000000000000000001100000000000000000000000000000000000001100000000000000000000000000000000000000000001
10000000000000000000001100000000000000000000000000000000000001100000000000000000000000000000000000000000001
10000000000000000000001100000000000000000000000000000000000001100000000000000000000000000000000000000000001
10000000000000000000001100000000000000000000000000000000000001100000000000000000000000000000000000000000001
10000000000000000000001100000000000000000000000000000000000001100000000000000000000000000000000000000000001
10000000000000000000001100000000000000000000000000000000000001100000000000000000000000000000000000000000001
10000000000000000000001100000000000000000000000000000000000001100000000000000000000000000000000000000000001
10000000000000000000001100000000000000000000000000000000000001100000000000000000000000000000000000000000001
10000000000000000000001100000000000000000000000000000000000001100000000000000000000000000000000000000000001
10000000000000000000001100000000000000000000000000000000000001100000000000000000000000000000000000000000001
10000000000000000000001100000000000000000000000000000000000001100000000000000000000000000000000000000000001
10000000000000000000001100000000000000000000000000000000000001100000000000000000000000000000000000000000001
10000000000000000000001100000000000000000000000000000000000001100000000000000000000000000000000000000000001
10000000000000000000001100000000000000000000000000000000000001100000000000000000000000000000000000000000001
10000000000000000000001100000000000000000000000000000000000001100000000000000000000000000000000000000000001
10000000000000000000001100000000000000000000000000000000000001100000000000000000000000000000000000000000001
10000000000000000000001100000000000000000000000000000000000001100000000000000000000000000000000000000000001
10000000000000000000001100000000000000000000000000000000000001100000000000000000000000000000000000000000001
10000000000000000000001100000000000000000000000000000000000001100000000000000000000000000000000000000000001
10000000000000000000001100000000000000000000000000000000000001100000000000000000000000000000000000000000001
10000000000000000000001100000000000000000000000000000000000001100000000000000000000000000000000000000000001
10000000000000000000001100000000000000000000000000000000000001100000000000000000000000000000000000000000001
10000000000000000000001100000000000000000000000000000000000001100000000000000000000000000000000000000000001
10000000000000000000001100000000000000000000000000000000000001100000000000000000000000000000000000000000001
10000000000000000000001100000000000000000000000000000000000001100000000000000000000000000000000000000000001
10000000000000000000001100000000000000000000000000000000000001100000000000000000000000000000000000000000001
10000000000000000000001100000000000000000000000000000000000001100000000000000000000000000000000000000000001
10000000000000000000001100000000000000000000000000000000000001100000000000000000000000000000000000000000001
10000000000000000000001100000000000000000000000000000000000001100000000000000000000000000000000000000000001
10000000000000000000001100000000000000000000000000000000000001100000000000000000000000000000000000000000001
10000000000000000000001100000000000000000000000000000000000001100000000000000000000000000000000000000000001
10000000000000000000001100000000000000000000000000000000000001100000000000000000000000000000000000000000001
10000000000000000000001100000000000000000000000000000000000001100000000000000000000000000000000000000000001
10000000000000000000001100000000000000000000000000000000000001100000000000000000000000000000000000000000001
10000000000000000000001100000000000000000000000000000000000001100000000000000000000000000000000000000000001
10000000000000000000001100000000000000000000000000000000000001100000000000000000000000000000000000000000001
10000000000000000000001100000000000000000000000000000000000001100000000000000000000000000000000000000000001
10000000000000000000001100000000000000000000000000000000000001100000000000000000000000000000000000000000001
11111111111111111111111111111111111111111111111111111111111111111111111111111111111111111111111111111111111