NO ./texture/sand_wall.xpm
SO ./texture/sand_wall.xpm
WE ./texture/sand.xpm
EA ./texture/sand.xpm

F 255,100,0
C 225,30,0

        1111111111111111111111111
        1000000000110000000000001
        1011000001110000000000001
        1001000000000000000000001
111111111011000001110000000000001
100000000011000001110111111111111
11111111111111111111011111111111
11111111111110001111111011111111
11110111111101111100000010001
11110111111101011101010010001
11000000111001011100000011011
100000001 1000001100000100101
10000000111000001101010010011
11000001110101011111011000N0111
11110111 1110101 111111010001
11111111 1111111 11111111111
