NO ./texture/egg.xpm
SO ./texture/egg.xpm
WE ./texture/egg.xpm
EA ./texture/egg.xpm

F 255,100,0
C 225,30,0

11111111111111
10000000000001
10000000000001
10000000000001
10000000000001
10000000000001
10000000000001
10000N00000001
10000000000001
10000000000001
10000000000001
10000000000001
10000000000001
10000000000001
10000000000001
11111111111111
