NO ./texture/test.xpm
SO ./texture/egg.xpm
WE ./texture/sand_wall.xpm

C 229,255,255
F 120,255,160

111111
100101
1000W1
111101
111101
110001
111111
