NO ./texture/test.xpm
SO ./texture/egg.xpm
WE ./texture/sand_wall.xpm
EA ./texture/sand.xpm

C 229,255,255
F 204,255,204

110111
100101
0000N1
111101
111101
110001
111111
